###########################################################################################
#P..#...#.........#.#.......#.#...#.......#...#...#.....#...#...#...#.......#...........#.#
###.#.#.#.#######.#.#.#####.#.#.###.#####.#.#.#.#.#.###.#.#.###.#.#.###.#.#.#.#########.#.#
#.....#.#...#...#...#...#...#.....#.#.....#.#.#.#...#.....#.......#...#.#.#.#.......#.#.#.#
#.#########.###.###.#####.#######.#.#.#######.#.#####.#.#######.#####.#.#.#########.#.#.#.#
#.#...#...#...#.#...#...#.#...#.....#.#...#...#.#...#.#...#.....#...#...#.#...#.......#.#.#
#.###.#.#.###.#.#.###.#.#.#.###.#.###.###.#.###.#.#.#.#####.#####.#.#.###.#.#.#####.###.#.#
#.#...#.#.....#...#...#.#.#.#...#.#.#...#.#.#...#.#...#.......#...#.#...#.#.#.....#.#.....#
#.#.#######.###.###.###.#.#.#.###.#.###.#.#.#.###.#####.###.#.#.###.#.###.#.#####.###.#.###
#...#.....#...#.#...#.#.#.....#...#...#.#.#.#...#...#.#.#...#...#.#.#...#...#...#.....#...#
#.###.###.#.#.###.###.#.#######.#####.#.#.#.#######.#.#.#.#######.#.###.#####.#.#####.#.###
#...#...#.#.#.#...#.#.#.....#...#.....#...#.....#...#...#.......#...#.....#...#.#...#.#...#
###.###.#.#.#.#.###.#.#####.#.###.###.#########.#.#############.#########.#.###.###.#####.#
#.......#...#.#.#.........#.#.#...#...#...#...#.#.......#...#.#.#...#...#.#...#.#.......#.#
#############.#.#.#########.#.#.###.###.#.#.#.#.#.#.#####.#.#.#.###.#.#.#######.#.#.###.#.#
#.......#.....#.#.....#.....#.....#.....#.#.#.#.#.#.......#...#.....#.#.....#.....#...#...#
#.#######.#####.#####.#.#######.#.#######.#.#.#.#########.#.#########.#####.#.#############
#.#.....#.......#.#...#...#...#.#.....#...#.#.......#.....#...#.....#.#.....#...........#.#
#.#.###.#########.#.#.###.###.#.#####.#.###.#######.#####.###.#.###.###.###############.#.#
#...#.....#.....#...#...#...#...#.....#...#.......#...#...#...#.#...#...#.....#.......#...#
#####.###.#.###.#.#.###.###.#.###########.#######.###.#####.#.#.#.###.#######.#####.#####.#
#...#...#.#...#...#...#.....#.....#.......#.....#.#...#...#.#...#.#.#.......#.....#.....#.#
###.###.#.###########.###.###.###.#.#######.###.#.#.###.#.#.#####.#.#####.#####.#######.#.#
#...#...#.........#...#.#.#.#...#.#.#...#...#...#.#.....#.#.....#.......#.#.....#.....#.#.#
#.###.###########.#.###.#.#.###.#.#.#.#.#.###.###########.#####.#######.#.#.###.#.###.#.#.#
#...#...#.......#...#...#.#.....#.#.#.#.#.#...#.....#...#.#...#.....#...#.#...#.#.#...#.#.#
###.###.#.###.#.#####.#.#.#######.#.#.#.#.#.#######.#.#.#.#.#.#####.#.###.#.#.###.#.#.#.#.#
#.#.....#.#...#...#...#.#...#.#...#...#...#...#...#...#.....#...#.#.#.....#.#.....#.#...#.#
#.#.#####.#######.#.#.#.###.#.#.#############.#.#.#######.#####.#.#.###############.#####.#
#...#...#...#...#...#.#...#.....#.........#.#...#.............#.....#.......#...#.#...#...#
#######.###.#.###########.#.#####.#######.#.#######.#.###.###.###.#########.###.#.#.#.#.###
#.....#...#.#...#.....#...#.#...#.......#.#.......#.#...#.#.....#...#.....#...#.#.#.#.#...#
#.###.###.#.###.#.###.#.#####.#.#######.#.#####.#.#.#####.#.#######.#.###.#.#.#.#.###.###.#
#.#...#.....#...#...#.#.......#.....#...#.......#.#.#...#.#.#.#.....#...#.#.#.....#...#...#
###.#.#.#####.#####.#########.#.###.#############.###.#.#.#.#.#.#########.#.###.###.###.###
#...#.#.#...#.#...#.........#.#...#.......#.....#.....#...#.#.#.#...#...#.#.#.......#.#...#
#.#####.#.#.#.###.#########.#############.#.#.#.###########.#.#.###.#.#.#.###.#.#####.###.#
#...#...#.#.#.#.........................#.#.#.#.......#.#...#.#...#...#.#...#.#.#...#.#O#.#
#.#.#.#####.#.#.#####################.###.###.#######.#.#.#.#.#.#.#.###.#.#.#.#.###.#.#.#.#
#.#.........#.......................#...............#.....#.#...#...#.....#...#.....#.....#
###########################################################################################