###########################################################################################
#...#.....#...#...#.............#...#.....#.....#.#...............#.....#...#.........#...#
#.#.#.###.#.#.###.#.###########.#.#.#####.#.###.#.#.###########.#.###.#.#.#.#########.#.#.#
#.#...#...#.#.#.....#...........#.#...#...#...#.#.#.#.....#.....#.#...#.#.#...........#.#.#
#.#######.#.#.#.#.###.###########.###.#.#######.#.#.#.#####.#####.#.###.#.#######.#######.#
#.#P#.....#.#.#.#...#.#...........#...#.#.......#...#.#.....#.......#.#.#...#.....#.....#.#
#.#.#.#####.#.#####.#.#.###########.#.#.#.#######.###.###.###########.#.###.#.#######.#.#.#
#...#.......#...#.#.#...#.....#.....#.#.#.#.....#.#...#...#.......#...#.#...#.........#...#
###############.#.#.#####.###.#.#######.#.#####.#.#.###.###.#####.#.###.#.#####.###########
#...#.........#...#...#...#...#.....#...#.......#...#...#...#...#.#...#...#.....#.........#
###.#.###.###.#.#.###.#.###.#######.#.###.###.#######.###.###.#.#.###.#####.#.###.#######.#
#.....#.#...#.#.#.#...#...#...#.#.....#.....#.#.....#...#.....#.#.#...#.....#...#.....#...#
#.#####.#.#.###.#.#.#####.###.#.#.#.###.#.#.###.###.###.#########.#.###.#######.#.###.#.###
#...#...#.#.....#.#.....#.#...#.#.#.#...#.#.#...#.....#...#.........#.......#...#...#.#.#.#
###.#.###########.#.###.###.###.#.#.#######.#.###.#.#.#.###.#####.#########.#.#######.#.#.#
#...#...#.......#...#.#...#...#...#...#...#...#...#.#.#.#...#...#...........#.#...#...#...#
#.###.#.#.#####.###.#.###.#.#########.#.#.#####.###.#.#.#.###.###############.#.#.#.#.###.#
#...#.#.#.#.....#.#.#.....#.#.....#.#.#.#.....#...#.#.#.#...#.....#.....#...#.#.#.#.#.#...#
###.#.#.###.#####.#.#######.#.###.#.#.#.#####.#####.#.#.###.#####.#.#.#.#.#.#.#.#.#.#.#####
#.....#.....#.....#...#...#.#...#...#...#...#...#...#.#.#.#.#...#...#.#...#...#.#.#.#.....#
###.#####.#######.###.###.#.###.#########.#####.#.###.#.#.#.#.#.###############.#.#.###.#.#
#...#...#...#...#...#.#.....#.#.#...#.....#.....#.#.....#.....#.#...#...........#...#.#.#.#
#.###.#.###.#.#.###.#.#.#.###.#.#.###.#####.#####.#.#######.###.###.#.#######.#######.#.#.#
#.....#.#.#...#.....#.#.#.#...#.....#.....#.#.....#.#.......#...#.....#.....#.....#.#.#.#.#
#######.#.###########.#.#.#.#.#####.#####.#.#.#######.#######.###.###.#.###.#####.#.#.#.#.#
#.......#...#.......#...#.#.#.#.............#...#.....#.........#...#.#...#.......#.#...#.#
#.#########.#.#####.#####.#.#.#.#####.###.#####.#.#####.#.#########.#.###.#########.#####.#
#.#.....#.#...#.....#...#.#.#.#.....#.#.......#.#.#.#...#.....#.....#.#.......#...#...#...#
#.#.###.#.#####.#######.#.###.#####.#.#######.#.#.#.#.#######.#.#####.#######.#.#.###.#.###
#.#.#.#.#.....#.....#.....#...#.....#...#...#...#.#.......#...#.#...#.#.......#.#...#...#.#
#.#.#.#.#####.###.###.#####.###########.#.#.#####.#.#######.###.#.#.###.#######.#####.###.#
#.#.#...#...#.#...#...#.....#...#.......#.#.#.....#.#...#...#...#.#.....#.....#...#...#.#.#
#.#.#####.#.#.#.###.###.#.#.#.#.###########.#.#.###.#.#.#.###.###.###########.###.#.###.#.#
#.#.#.....#.#.#.....#...#.#.#.#...........#...#...#.#.#.#...#.#...#...#.....#.......#.....#
#.#.###.###.#.#######.###.#.#.#####.#####.###.###.###.#.###.#.#.###.#.#####.#########.###.#
#.#...#.#...#.........#...#...#...#.#...#.....#...#...#...#...#.#...#.........#.......#...#
#.#.#.#.#.#############.#######.#.#.#.#########.###.#####.#####.#.#######.#####.#######.###
#.#.#.#.#.#.......#...#.#...#...#.#.#.....#.........#...#...#...#.#...#.......#.#...#...#O#
#.#.#.#.#.#.#####.#.#.#.###.#.#####.###.#.#######.#.#.#####.#.###.#.###.#.###.#.#.###.#.#.#
#...#...#...#.......#.#.....#.......#...#.........#.#.......#.....#.....#...#...#.....#...#
###########################################################################################