###########################################################################################
#P#...#.....#...........#.....#...#.....#...#.....#.........#.....#.....#.....#...#.......#
#.#.#.###.###.#######.###.###.#.#.#.###.#.#.#.###.#.#######.#.###.#.###.#####.#.#.###.###.#
#.#.#...#.....#...#...#...#.#.#.#...#.#.#.#.#...#...#...#.......#.#...#.......#.#.....#...#
#.#####.#########.#.#.#.###.#.###.###.#.#.#.###.#######.#######.#####.#########.#######.###
#.#...#.........#.#.#...#.#...#...#.....#.#.#.#.......#...#...#.....#.#.........#.....#.#.#
#.#.#.#.#.#####.#.#######.#.###.#########.#.#.###.###.#.#.#.#.#####.#.#.#####.#######.#.#.#
#.#.#.#.#...#...#...#...#.#...#.....#...#.#...#...#.#...#...#...#.#.....#.....#.......#...#
#.#.#.#.#.#.#.###.#.#.#.#.###.#####.#.#.#.#####.###.###########.#.###.###.#####.#######.#.#
#...#...#.#.#.....#...#...#...#.#...#.#.#.#...#.....#.....#.#...#...#.#.#.#...#...#...#.#.#
###########.###.###########.###.#.#.###.#.#.#.###########.#.#.#####.#.#.#.#.#.###.#.#.#.###
#.......#...#...#.....#...#.#...#.#...#...#.#...#.....#...#...#.....#.#.#.#.#.....#.#.....#
#.###.###.###.###.###.#.###.#.###.#.#.###.#####.#.###.#.#######.#.###.#.#.#####.#########.#
#.#...#...#.#...#.#...#...#.....#.#.#.#.#.#...#.#.#...#.#.....#.#...#.#...#...#.....#.....#
#.#####.###.###.#.#.#####.###.###.###.#.#.#.#.#.###.###.#####.#.#####.#####.#.#####.#.#####
#.....#.#.#.....#.#.....#...#...#.#...#...#.#...#...#.........#.....#.#...#.#.#.....#...#.#
#####.#.#.#######.#####.###.#.#.#.#.###.###.#####.###.#############.#.#.#.#.#.#.#######.#.#
#.....#...#...#...#...#.....#.#.#.#.....#...#...#.#.#.....#.#.....#...#.#...#...#.....#...#
#.###.#.###.#.#.###.###########.#.#######.###.#.#.#.#####.#.#.###.#.###.#####.###.###.#####
#.#.#...#.#.#.#.........#...#...#.#...#...#...#.#.#.#.....#.....#...#.#.#...#.#...#...#...#
#.#.###.#.#.#.#####.#####.#.#.###.#.#.#.###.#####.#.#.#####.#.#######.#.#.###.#####.###.#.#
#.....#...#.#...#.........#...#...#.#...#...#...#.....#.....#...........#.....#.....#...#.#
#####.#####.###.###.#######.###.#.#.#####.###.#.###.###.#############.#########.#########.#
#.......#.....#...........#.#...#...#...#...#.#.....#...#.......#...#...#.......#.....#...#
#.#####.#####.#########.###.#.#######.#.###.#.#.###.#.###.#####.#.#.###.#.#.###.#.###.#.###
#.#...#.#...#...#...#.#...#...#.......#...#.#.#.#...#.#.#.....#.#.#.....#.#.#...#.#...#.#.#
#.###.###.#.#.#.#.#.#.#.#.#####.#.#######.#.#.###.###.#.###.#.#.#.#.#####.#.#####.#.###.#.#
#...#.....#.#.#.#.#...#.#.......#.#...#.#...#...#.#...#.....#.#...#.#.....#...#...#.#...#.#
###.#####.#.###.###.###.#.#######.#.#.#.###.###.#.#.#########.#####.#.#######.#.###.#.###.#
#.#.......#.......#.#...#.#...#.#.#.#...#...#.#.#.#.#...#...#.#.....#.#...#.....#...#.#...#
#.#########.###.#.#.#.###.#.#.#.#.#.#######.#.#.#.#.###.#.#.#.#######.#.###.#####.###.#.###
#.#...#...#.#...#.#.#.#...#.#.#...#.#.....#.#.#.#.#...#.#.#.#.........#.#...#...#.#.....#.#
#.#.#.#.#.#.#####.#.#.#.#####.###.#.#.###.#.#.#.#.#.#.#.#.#.###########.#.#####.#.###.###.#
#.#.#...#.#.#.....#...#.#.....#.#.#.#.#.#.#.....#...#...#.#.........#...#.#...#.#...#...#.#
#.#.#.###.#.#.#########.###.#.#.#.#.#.#.#.#####.#######.#.#########.#.###.#.#.#.###.###.#.#
#...#...#...#.#.....#.#...#.#.#.#...#...#...#...#.....#.#.....#...#.....#...#.#...#.#...#.#
#.###########.#.#.#.#.###.#.#.#.#########.#.#.#######.#######.###.###########.###.#.#.###.#
#.#.....#...#...#.#.#.....#.#.#.#.......#.#.....#...#.......#...#...............#.#...#...#
#.#.###.#.#########.#.#####.#.#.#.#####.#####.#.#.#.###.###.#.#.#####.###########.#.###.###
#...#...#...........#.......#...#.....#.......#...#.....#...#.#...................#......O#
###########################################################################################