###########################################################################################
#.......#.........#...#.......#.....#.......#.......#.........#.......#.........#...#.....#
#######.#.#######.###.#.#####.#.###.#.#####.#.#####.#.#.#####.#.#####.###.#####.#.###.###.#
#.......#.#.....#...#.#.#.....#...#.#...#.#.#.#...#.#.#.#.....#.#.....#.....#...#...#.#...#
#.#######.#.#######.#.#.#.#######.#.###.#.#.#.#.#.#.#.#.#.#####.#.#####.###.#.#####.#.#.###
#...#.....#.......#...#.#.#...#...#...#.#...#.#.#.#.#.#.#...#...#...#.#.#...#.#.#...#.#.#.#
###.#.###########.#######.#.#.#.#####.#.#.#####.#.#.#.#.###.#.#####.#.#.#.###.#.#.###.#.#.#
#.#......P..#...#...#.#.....#...#.....#.#...#...#.#.#.#...#...#.....#...#.#.#...#.#...#.#.#
#.#.#.#####.###.###.#.#.#.#######.#####.###.#.###.#.#.###.#####.#####.###.#.###.#.#.###.#.#
#...#.#...#...#...#.....#.....#...#...#.#.#...#.#.#.#...#.#.....#.....#.#.#.......#.#.#...#
#####.#.###.#.###.###########.#####.#.#.#.#.###.#.#.###.#.#.#####.#####.#.###.#####.#.#####
#...#.#.....#...#.....#.#.....#.....#.#.#.#...#...#.#...#.#.#...#.#...#...#.....#...#...#.#
#.#.#.#########.#####.#.#.###.#.###.###.#.#########.###.#.#.#.#.#.#.#.#########.#.###.#.#.#
#.#.#.#...#.....#...#.#...#.....#.....#.#.....#...#...#.#.#...#...#.#...#...#...#.....#.#.#
#.#.#.#.#.#.#.###.#.#.#####.#####.###.#.#####.###.###.#.#.#.#######.###.#.#.#.#######.#.#.#
#.#.#.#.#.#.#.....#.#.#...#.#...#.#...#...#...#...#...#.#.#.#.#...#.#.....#.#.#...#...#...#
#.#.#.###.#.#######.#.#.#.#.#.#.#.#.#####.###.#.###.#####.#.#.#.#.###.#####.#.#.#.#.#######
#.#.#.#...#...#...#.#.#.#...#.#...#.....#...#.#...#.#...#.#...#.#...#.#.....#...#.#.#.....#
#.###.#.#######.#.#.#.###.###.###########.#.#.#.###.#.#.#.#.#.#.###.#.#.#########.#.#####.#
#.#...#.#.......#.#...#...#...#...#.#...#.#.#.#...#.#.#...#.#...#...#.#.....#...#.#.....#.#
#.#.###.#.#######.#####.###.#####.#.#.#.###.#.###.#.#.#####.#####.###.#####.#.###.#####.#.#
#.....#.#.#.....#.#.#...#.#.#.....#...#.....#.#...#.#...#.#.#.....#...#...#.#...#.........#
###.#.#.#.###.###.#.#.###.#.#.#######.#######.#.###.###.#.#.#########.#.#.#.###.#.#.###.###
#...#...#...#.....#...#...#...#.#.....#.....#.#.........#.........#...#.#.#.#.#...#...#.#.#
#.#########.#.#######.#.#######.#.#####.###.#.#####.#######.#####.#.###.#.#.#.#######.#.#.#
#.#...#...#.#.#.#.....#.#.....#...#...#...#...#.....#.....#.#.....#.#...#...#.....#...#.#.#
#.#.#.#.#.###.#.#.#####.#.###.###.#.#.###.#######.###.###.#.#######.#.###########.#.###.#.#
#...#...#...#.....#.......#.........#.....#.#.....#.#.#...#.....#.#.#...#...#...#.#.#.....#
###########.###.#############.###.#########.#.###.#.#.#########.#.#.###.###.#.###.###.#.###
#.#...#.....#.....#.........#.#.#.....#.........#.#.#.#...#.....#.#.#...#...#...#.....#.#.#
#.#.#.#####.#.#####.#######.#.#.#####.#########.###.#.#.#.#.#####.#.#.###.#####.#######.#.#
#.#.#.#.......#.....#.....#.........#.......#...#...#...#...#...#...#...#.#.....#...#...#.#
#.#.#.#.#######.#####.###.###.#####.#######.#.#.#.#######.###.#.#.###.###.#.#####.#.#.###.#
#...#...#...#...#.....#.#...#.....#...#.....#.#.#.#.........#.#...#...#...#.#.....#.#.....#
#.#########.#.#####.###.#.#.#########.#.#####.###.#.#########.#######.#.###.#.#######.#####
#.#.#.........#...#.#.#...#...........#...........#.#.....#...#.........#...#.O.#.........#
#.#.#.#.###.#####.#.#.#########.###################.#.#.#.#.###.#########.###.#.#.#######.#
#.#...#...#...#...#.#.........#.#...#.............#...#.#...#...#...........#.#.#.....#...#
#.#.#####.#.###.###.#####.###.#.###.#.###########.#####.#####.###.#########.#.#.#####.#.###
#...#.....#.....#.........#...#.....#...........#.......#.........#.........#.#.......#...#
###########################################################################################